F 204,204,255
C 102,255,255

NO ./textures/north.xpm	
SO ./textures/south.xpm
WE ./textures/west.xpm
EA ./textures/east.xpm

11111111111111111111111111111111111111111111111111111111111111111
10000000000000000001000000000000000000111000000000000000000111111
10000000001000000001000000000000000000111000000000000000000111111
10001000000000000001000000000N00000000111000000000000000000111111
10000000000000000001000000000000000000111000000000000000000111111
10000000001000000001000000000000000000111000000000000000000111111
1111111111111111111111111111111111111111111111111111111111111111